ក	ka
ខ	kha
គ	ga
ឃ	gha
ង	nga
ច	ca
ឆ	cha
ជ	ja
ឈ	jha
ញ	nya
ដ	ta
ឋ	tha
ឌ	da
ឍ	dha
ណ	na
ត	ta
ថ	tha
ទ	da
ធ	dha
ន	na
ប	pa
ផ	pha
ព	ba
ភ	bha
ម	ma
យ	ya
រ	ra
ល	la
វ	va
ស	sa
ហ	ha
ឡ	la
អ	qa
(.)a៌	r$1a
a៉	a
aា	aa
aិ	i
aី	ii
aឹ	ı
aឺ	ıı
aុ	u
aូ	uu
aួ	ua
aើ	e
aឿ	ıa
aៀ	ia
aេ	ë
aែ	ä
aៃ	ëë
aោ	o
aៅ	oo
a្	-
a់	-
ំ	m
ះ	h
C=[^aeiouıëä]
(<C>)h(<C>)	$1$2